
NO ./spaceship/wall_1.xpm
SO ./spaceship/wall_2.xpm


EA ./spaceship/wall_3.xpm

WE ./spaceship/wall_4.xpm

F 255.127.0




C 62,41,92



111111111111111111
100000000000000001
100000000000000001
1N0000000000000001
111111111111111111
