NO ./texture/spaceship/wall_1.xpm
SO ./texture/spaceship/wall_2.xpm


EA ./texture/spaceship/wall_3.xpm

WE ./texture/spaceship/wall_4.xpm

F 255.127.0




C 62,41,92

1111
1001 111
10011101
10000001
10W00001 
11110111
   111
