
NO texture/ugly/texture_north.xpm
SO ./texture/ugly/texture_south.xpm


EA ./texture/ugly/texture_east.xpm

WE ./texture/ugly/texture_west.xpm

F 255.127.0




C 62,41,92








        1111111111111111111111111
        1000000000110000000000001
        1011000001110000000000001
        1001000000000000000000001
111111111011000001110000000000001
100000000011000001110111111111111
11110111111111011100000010001      111
11110111111111011101010010001      101
11000000110101011100000010001      111
10000000000000001100000010001
1000000000N000001101010010001      111
1100000111010101111101111000111    111
11110111 1110101 101111010001      111
11111111 1111111 111111111111
